%%%%%%%%%%%%%%%%%%%%
%....@.....@.$.....%
%.*..@$...@@@@...@.%
%....@...$.......@.%
%%%%%%%%%%%%%%%%.$.%
%....@@...@....@...%
%.@...$..@...$.@...%
%.@.%%%%%%%%%%%%%%%%
%$.@...@.@...$@....%
%....@@..@$...@$..@!
%.$....@.@..@..$..@%
%%%%%%%%%%%%%%%%%%%%