====================
===#########========
===#...@...######===
===#.&....@@...!#===
===#.*...&.######===
===#. .....#========
==######...######===
==#$$$$#@..@$$$$#===
==#$$$$#####$$$$#===
==#$$$$#===#$$$$#===
==######===######===
====================